#............#
............g.
#.............
....r.........
#......#......
#.....##...##.
...........##.
...........##.
..b........##.
.....###...##.
.....#........
#..y..........
#.........o.#.
###....p....##